1,1,1,1,1,1,1,1,1,1,1,1,1,1,1,1,1,1,1,1,1,1,1,1,1,1,1,1,1,1,1,1,1,1,1,1,1,1,1,1,1,1,1,1,1,1,1,1,1,1
1,1,1,1,1,1,1,1,1,1,1,1,1,1,1,1,1,1,1,1,1,1,1,1,1,1,1,1,1,1,1,1,1,1,1,1,1,1,1,1,1,1,1,1,1,1,1,1,1,1
1,1,1,1,1,1,1,1,1,1,1,1,1,1,1,1,1,1,1,1,1,1,1,1,1,1,1,1,1,1,1,1,1,1,1,1,1,1,1,1,1,1,1,1,1,1,1,1,1,1
1,1,1,1,1,1,1,1,1,1,1,1,1,1,1,1,1,1,1,1,1,1,1,1,1,1,1,1,1,1,1,1,1,1,1,1,1,1,1,1,1,1,1,1,1,1,1,1,1,1
1,1,1,1,1,1,1,1,1,1,1,1,1,1,1,1,1,1,1,1,1,1,1,1,1,1,1,1,1,1,1,1,1,1,1,1,1,1,1,1,1,1,1,1,1,1,1,1,1,1
1,1,1,1,1,1,1,1,1,1,1,1,1,1,1,1,1,1,1,1,1,1,1,1,1,1,1,1,1,1,1,1,1,1,1,1,1,1,1,1,1,1,1,1,1,1,1,1,1,1
1,1,1,1,1,1,1,1,1,1,1,1,1,1,1,1,1,1,1,1,1,1,1,1,1,1,1,1,1,1,1,1,1,1,1,1,1,1,1,1,1,1,1,1,1,1,1,1,1,1
1,1,1,1,1,1,1,1,1,1/500:4/*:1,1,1,1,1,1,1,1,1,1,1,1,1,1,1,1,1,1,1,1,1,1,1,1,1,1,1,1,1,1,1,1/500:4/*:1,1,1,1,1,1,1,1,1,1
1,1,1,1,1,1,1,1,1/500:4/*:1,1/500:4/*:1,1/500:4/*:1,1,1,1,1,1,1,1,1,1,1,3,3,3,3,3,3,3,3,1,1,1,1,1,1,1,1,1,1,1/500:4/*:1,1/500:4/*:1,1/500:4/*:1,1,1,1,1,1,1,1,1
1,1,1,1,1,1,1,1/500:4/*:1,1/500:4/*:1,1/500:4/*:1,1/500:4/*:1,1/500:4/*:1,1,1,1,1,1,1,1,1,0/*:3,0/*:3,0/*:3,0/*:3,0/*:3,0/*:3,0/*:3,0/*:3,0/*:3,0/*:3,1,1,1,1,1,1,1,1,1/500:4/*:1,1/500:4/*:1,1/500:4/*:1,1/500:4/*:1,1/500:4/*:1,1,1,1,1,1,1,1
1,1,1,1,1,1,1,1,1/500:4/*:1,1/500:4/*:1,1/500:4/*:1,1,1,1,1,1,1,1,1,1,1,3,3,3,3,3,3,3,3,1,1,1,1,1,1,1,1,1,1,1/500:4/*:1,1/500:4/*:1,1/500:4/*:1,1,1,1,1,1,1,1,1
1,1,1,1,1,1,1,1,1,1/500:4/*:1,1,1,1,1,1,1,1,1,1,1,1,1,1,1,1,1,1,1,1,1,1,1,1,1,1,1,1,1,1,1,1/500:4/*:1,1,1,1,1,1,1,1,1,1
1,1,1,1,1,1,1,1,1,1,1,1,1,1,1,1,1,1,1,1,1,1,1,1,1,1,1,1,1,1,1,1,1,1,1,1,1,1,1,1,1,1,1,1,1,1,1,1,1,1
1,1,1,1,1,1,1,1,1,1,1,1,1,1,1,1,1,1,1,1,1,1,1,1,1,1,1,1,1,1,1,1,1,1,1,1,1,1,1,1,1,1,1,1,1,1,1,1,1,1
1,1,1,1,1,1,1,1,1,1,1,1,1,1,1,1,1,1,1,1,1,1,1,1,1,1,1,1,1,1,1,1,1,1,1,1,1,1,1,1,1,1,1,1,1,1,1,1,1,1
1,1,1,1,1,1,1,1,1,1,1,1,1,1,1,3,3,3,3,1,1,1,1,1,1,1,1,1,1,1,1,3,3,3,3,1,1,1,1,1,1,1,1,1,1,1,1,1,1,1
1,1,1,1,1,1,1,1,1,1,1,1,1,1,1,3,3,3,3,3,1,1,1,1,1,1,1,1,1,1,3,3,3,3,3,1,1,1,1,1,1,1,1,1,1,1,1,1,1,1
1,1,1,1,1,1,1,1,1,1,1,1,1,1,1,3,3,0/*:1,0/*:1,0/*:1,0/*:1,0/*:1,0/*:1,1,1,1,1,0/*:1,0/*:1,0/*:1,0/*:1,0/*:1,0/*:1,3,3,1,1,1,1,1,1,1,1,1,1,1,1,1,1,1
1,1,1,1,1,1,1,1,1,1,1,1,1,1,1,3,3,0/*:1,2,2,2,2,2,2,2,2,2,2,2,2,2,2,0/*:1,3,3,1,1,1,1,1,1,1,1,1,1,1,1,1,1,1
1,1,1,1,1,1,1,1,1,1,1,1,1,1,1,1,3,0/*:1,2,2,2,2,2,2,2,2,2,2,2,2,2,2,0/*:1,3,1,1,1,1,1,1,1,1,1,1,1,1,1,1,1,1
1,1,1,1,1,1,1,1,1,0/*:3,1,1,1,1,1,1,1,0/*:1,2,2,2,2,2,2,2,2,2,2,2,2,2,2,0/*:1,1,1,1,1,1,1,1,0/*:3,1,1,1,1,1,1,1,1,1
1,1,1,1,1,1,1,1,3,0/*:3,3,1,1,1,1,1,1,0/*:1,2,2,2,2,2,2,2,2,2,2,2,2,2,2,0/*:1,1,1,1,1,1,1,3,0/*:3,3,1,1,1,1,1,1,1,1
1,1,1,1,1,1,1,1,3,0/*:3,3,1,1,1,1,1,1,0/*:1,2,2,2,2,2,2,2,2,2,2,2,2,2,2,0/*:1,1,1,1,1,1,1,3,0/*:3,3,1,1,1,1,1,1,1,1
1,1,1,1,1,1,1,1,3,0/*:3,3,1,1,1,1,1,1,1,2,2,2,2,2,2,2,2,2,2,2,2,2,2,1,1,1,1,1,1,1,3,0/*:3,3,1,1,1,1,1,1,1,1
1,1,1,1,1,1,1,1,3,0/*:3,3,1,1,1,1,1,1,1,2,2,2,2,2,2,2,2,2,2,2,2,2,2,1,1,1,1,1,1,1,3,0/*:3,3,1,1,1,1,1,1,1,1
1,1,1,1,1,1,1,1,3,0/*:3,3,1,1,1,1,1,1,1,2,2,2,2,2,2,2,2,2,2,2,2,2,2,1,1,1,1,1,1,1,3,0/*:3,3,1,1,1,1,1,1,1,1
1,1,1,1,1,1,1,1,3,0/*:3,3,1,1,1,1,1,1,1,2,2,2,2,2,2,2,2,2,2,2,2,2,2,1,1,1,1,1,1,1,3,0/*:3,3,1,1,1,1,1,1,1,1
1,1,1,1,1,1,1,1,3,0/*:3,3,1,1,1,1,1,1,0/*:1,2,2,2,2,2,2,2,2,2,2,2,2,2,2,0/*:1,1,1,1,1,1,1,3,0/*:3,3,1,1,1,1,1,1,1,1
1,1,1,1,1,1,1,1,3,0/*:3,3,1,1,1,1,1,1,0/*:1,2,2,2,2,2,2,2,2,2,2,2,2,2,2,0/*:1,1,1,1,1,1,1,3,0/*:3,3,1,1,1,1,1,1,1,1
1,1,1,1,1,1,1,1,1,0/*:3,1,1,1,1,1,1,1,0/*:1,2,2,2,2,2,2,2,2,2,2,2,2,2,2,0/*:1,1,1,1,1,1,1,1,0/*:3,1,1,1,1,1,1,1,1,1
1,1,1,1,1,1,1,1,1,1,1,1,1,1,1,1,3,0/*:1,2,2,2,2,2,2,2,2,2,2,2,2,2,2,0/*:1,3,1,1,1,1,1,1,1,1,1,1,1,1,1,1,1,1
1,1,1,1,1,1,1,1,1,1,1,1,1,1,1,3,3,0/*:1,2,2,2,2,2,2,2,2,2,2,2,2,2,2,0/*:1,3,3,1,1,1,1,1,1,1,1,1,1,1,1,1,1,1
1,1,1,1,1,1,1,1,1,1,1,1,1,1,1,3,3,0/*:1,0/*:1,0/*:1,0/*:1,0/*:1,0/*:1,1,1,1,1,0/*:1,0/*:1,0/*:1,0/*:1,0/*:1,0/*:1,3,3,1,1,1,1,1,1,1,1,1,1,1,1,1,1,1
1,1,1,1,1,1,1,1,1,1,1,1,1,1,1,3,3,3,3,3,1,1,1,1,1,1,1,1,1,1,3,3,3,3,3,1,1,1,1,1,1,1,1,1,1,1,1,1,1,1
1,1,1,1,1,1,1,1,1,1,1,1,1,1,1,3,3,3,3,1,1,1,1,1,1,1,1,1,1,1,1,3,3,3,3,1,1,1,1,1,1,1,1,1,1,1,1,1,1,1
1,1,1,1,1,1,1,1,1,1,1,1,1,1,1,1,1,1,1,1,1,1,1,1,1,1,1,1,1,1,1,1,1,1,1,1,1,1,1,1,1,1,1,1,1,1,1,1,1,1
1,1,1,1,1,1,1,1,1,1,1,1,1,1,1,1,1,1,1,1,1,1,1,1,1,1,1,1,1,1,1,1,1,1,1,1,1,1,1,1,1,1,1,1,1,1,1,1,1,1
1,1,1,1,1,1,1,1,1,1,1,1,1,1,1,1,1,1,1,1,1,1,1,1,1,1,1,1,1,1,1,1,1,1,1,1,1,1,1,1,1,1,1,1,1,1,1,1,1,1
1,1,1,1,1,1,1,1,1,1/500:4/*:1,1,1,1,1,1,1,1,1,1,1,1,1,1,1,1,1,1,1,1,1,1,1,1,1,1,1,1,1,1,1,1/500:4/*:1,1,1,1,1,1,1,1,1,1
1,1,1,1,1,1,1,1,1/500:4/*:1,1/500:4/*:1,1/500:4/*:1,1,1,1,1,1,1,1,1,1,1,3,3,3,3,3,3,3,3,1,1,1,1,1,1,1,1,1,1,1/500:4/*:1,1/500:4/*:1,1/500:4/*:1,1,1,1,1,1,1,1,1
1,1,1,1,1,1,1,1/500:4/*:1,1/500:4/*:1,1/500:4/*:1,1/500:4/*:1,1/500:4/*:1,1,1,1,1,1,1,1,1,0/*:3,0/*:3,0/*:3,0/*:3,0/*:3,0/*:3,0/*:3,0/*:3,0/*:3,0/*:3,1,1,1,1,1,1,1,1,1/500:4/*:1,1/500:4/*:1,1/500:4/*:1,1/500:4/*:1,1/500:4/*:1,1,1,1,1,1,1,1
1,1,1,1,1,1,1,1,1/500:4/*:1,1/500:4/*:1,1/500:4/*:1,1,1,1,1,1,1,1,1,1,1,3,3,3,3,3,3,3,3,1,1,1,1,1,1,1,1,1,1,1/500:4/*:1,1/500:4/*:1,1/500:4/*:1,1,1,1,1,1,1,1,1
1,1,1,1,1,1,1,1,1,1/500:4/*:1,1,1,1,1,1,1,1,1,1,1,1,1,1,1,1,1,1,1,1,1,1,1,1,1,1,1,1,1,1,1,1/500:4/*:1,1,1,1,1,1,1,1,1,1
1,1,1,1,1,1,1,1,1,1,1,1,1,1,1,1,1,1,1,1,1,1,1,1,1,1,1,1,1,1,1,1,1,1,1,1,1,1,1,1,1,1,1,1,1,1,1,1,1,1
1,1,1,1,1,1,1,1,1,1,1,1,1,1,1,1,1,1,1,1,1,1,1,1,1,1,1,1,1,1,1,1,1,1,1,1,1,1,1,1,1,1,1,1,1,1,1,1,1,1
1,1,1,1,1,1,1,1,1,1,1,1,1,1,1,1,1,1,1,1,1,1,1,1,1,1,1,1,1,1,1,1,1,1,1,1,1,1,1,1,1,1,1,1,1,1,1,1,1,1
1,1,1,1,1,1,1,1,1,1,1,1,1,1,1,1,1,1,1,1,1,1,1,1,1,1,1,1,1,1,1,1,1,1,1,1,1,1,1,1,1,1,1,1,1,1,1,1,1,1
1,1,1,1,1,1,1,1,1,1,1,1,1,1,1,1,1,1,1,1,1,1,1,1,1,1,1,1,1,1,1,1,1,1,1,1,1,1,1,1,1,1,1,1,1,1,1,1,1,1
1,1,1,1,1,1,1,1,1,1,1,1,1,1,1,1,1,1,1,1,1,1,1,1,1,1,1,1,1,1,1,1,1,1,1,1,1,1,1,1,1,1,1,1,1,1,1,1,1,1
1,1,1,1,1,1,1,1,1,1,1,1,1,1,1,1,1,1,1,1,1,1,1,1,1,1,1,1,1,1,1,1,1,1,1,1,1,1,1,1,1,1,1,1,1,1,1,1,1,1